1111111111111
10100000000C1
1000011111001
10P011E000001
1111111111111
